####################
#.             $   #
#.             $   #
#.             $   #
#        @         #
####################

