####################
#.  .  .   .   $   #
#      $     $     #
#  $ ###############
#    #
#  @ #
######
