####################
#.         .   $   #
#                  #
#  $ ###############
#    #
#  @ #
######

