####################
#.             $   #
#                  #
#                  #
#        @         #
####################
