####################
#.    .    .   $   #
#      $           #
#  $ ###############
#    #
#  @ #
######
