         ####
         # @#
      ####  ####
      #        #
      # ## ### #
      # ###### #####
      #  $ .## #   #
  ######### #      #
  #   ## ## ## #   #
### #       ## #####
#     #  ##### #
# ### #  #     #
#   ######    ##
#   $.     ####
############