
#################
# @         $  .#
#    $         .#
#               #
#################