    #####
    #   #
    #$  #
  ###   ##
  #      #
###$# ## #   ######
#   # ## #####    #
#                .#
##### ### #@##    #
    #.    #########
    #######