    #####
    #   #
    #$  #
  ###   ##
  #      #
### # ## #   ######
#   # ## #####    #
#                .#
##### ### #@##    #
    #     #########
    #######