        #####
        #   #####
        # #$##  #
        #       #
######### ###   #
#.     ##     ###
#             ##
#      ##     @#
#########     ##
        #      #
        ### ## #
          #    #
          ######