#############
#.          #
#           #
#  $ ########
#    #
#  @ #
######
